
======= Promotions =======
Ace Hotel | Final day for 2026 room deals
Amazon.com | Unlocked: Earn 2x Kindle Points, starting today! (Feb 13)
Anthropologie | You have a special offer waiting ğŸ‘€
AP Afternoon Wire | Greenland poll; Epstein fallout; Winter Olympics
Athleta | You're in luck: this style is on sale
Better Homes and Gardens | HVAC Pros Reveal the Ideal Winter Home Temperature to Save Energy
Blinds.com | Presidents' Day Mega Sale starts now ğŸ‰
Broadway in Hollywood | Alicia Keys' Hell's Kitchen is Now On Presale.
Bruno Mars | Tune In to TalkShopLive's 'The Romantic' Fan Event Now!
Christopher Kimball's Milk Street | Milk Streetâ€™s Cast Iron Sale Starts Now
CNN's 5 Things AM | DHS on brink of shutdown
CNNâ€™s 5 Things PM | Returning to the moon, strange ski season, Wendy's woes
Consumer Reports | Linda, please review: You're eligible
EatingWell | The One Tea You Should Drink for Lower Blood Pressure
Elissa Slotkin | They tried to indict me.
Elizabeth Warren | Will you help me send this progressive fighter to the Senate?
Emily | Whiskertons | Purr-fect gifts for your valentine ğŸ˜»
EWS | Florida is putting public schools on the ballot â€” literally
Fine Gardening | Repair and Prevent Winter Garden Damage
Food & Wine - Partner Offers | Plan a Summer Weekend in Aspen
Gap | Gap Ã— Harlemâ€™s Fashion Row is back
Gavin Newsom | Effectively end Trump's presidency
Google News | Today's Briefing: Savannah Guthrie, Politics, Celebrities, TV, and Food
Grubhub Delivery Fee Settlement | Wang v Grubhub Delivery Fee Settlement
Instacart | Who says you have to go out on Valentine's Day?
JustFlowers.com | ğŸš¨ Valentine's Day is Tomorrow - Use Your $16.03 Credit Today!
Keurig | $10.99/box when you buy 4+ â€” Valentineâ€™s treat inside
Lands' End | Extra 70% off clearance: One-Day Flash Sale starts now!
Laura Geller | Presidents' Day Deals Are LIVE ğŸ‰ Up to 65% OFF + an EXTRA 15%
Levenger Company | Free Shipping + Sale Continues.
Live Nation Concerts | Singles Awareness Week! Get A $40 Ticket to Netflix Is A Joke Fest!
Long Beach Post | Lawmaker targets federal agents' use of flashbangs, tear gas
Mark Kelly | My decision
MOD Pizza | NATIONAL PIZZA DAY $9 DEAL? Yeah, That's at MOD.
Nextdoor Local News | LA County supervisors place sales-tax hike for health care on June ballot
NYT Cooking | Chicken and sausage gumbo, letâ€™s go
NYT Wirecutter | 9 very good-looking nightstands
p a c t Â® | Starting Today: Entire Site on Sale
Pete Buttigieg | Will I see you next week?
Pizza Hut | Besties + heart-shaped pizza for $11.99 ğŸ’•
Plant People | Your Galentineâ€™s glow ritual
Polly's Pies Restaurant | Berry Good Deal Ending Soon! ğŸ“
Pottery Barn Kids Sale | ğŸ‰ Presidents' Day Sale Starts NOW ğŸ‰
Real Simple | We Asked the Experts Which Nut Butter Is Healthiestâ€”and Their Answer Was Unanimous
Reyn Spooner | Itâ€™s Baaaaack: The Sunset Sale Returns ğŸŒ…
Ro Khanna | The â€œunredactedâ€ Epstein files are still redacted
Robert Garcia | Pam Bondi is a disgrace
Rossella Rago | FLASH SALE - TODAY 1/30 ONLY!  Use code FLASH20 and Save 20% on Your Order!
Sarah McBride | This is not normal politics ğŸš¨
Seed | Sale starts TODAY.
South Coast Repertory | A Weekend with the OG Carrie Bradshaw
Taos Footwear | The Best Valentine? You.
The Associated Press | Top Goldman Sachs lawyer to resign after emails show ties to Epstein
The Democrats | We are being out-raised:
The New York Times | The Book Review: Your 101 Guide to Romance Novels
The New Yorker | Limited-time offer. Unlock Access for $1 a Week
Ticketmaster | Presale - Josh Groban: GEMS The Las Vegas Residency
WellBefore | Give the gift of care. ğŸ’“
Wilt | Are You Ready to Save 25% on Blush & Beauty Today? â¤ï¸
Women's March | For Our Mothers. For Our Daughters.

======= Spam =======
Michael Phelan, Social Security Works | Iâ€™m starting to think we shouldnâ€™t have let Elon Musk push out 7,000 Social Security workers

======= Social =======
Nextdoor Local News | LA County supervisors place sales-tax hike for health care on June ballot
Weekend Events in Country Club Manor | Irene and other neighbors are planning to attend Blood Drive at the Y

======= Receipts =======
Porto's Bake at Home | FINAL HOURS: Order by 3 PM PT for Valentine's DayğŸ’˜

======= Updates =======
EatingWell Recall Alert | Recall Alert: Salmon
